R 1920 1080


NO ./path_to_the_north_texture


SO ./path_to_the_south_texture


WE ./path_to_the_west_texture
EA ./path_to_the_east_texture
S ./path_to_the_sprite_texture
F 220,100,0
C 225,30,0



         1111111111111111111111
        100000001100000000000011
        1011000001110000002000001
        1001000000000000000000001
111111111011000001110000000000001
1000000000110N0001110111111111111
11110111111111011100000010001
1111011111111101110101000000111111111
1100000011010101110000001000000000001111111111
10002000000000001100000010001000001111111111 1
1000000000000000110101001000100000000000001111
110000011101010111110111100011000000000111
11110111 1110101 1011110100011111111111
11111111 1111111 111111111111