R 1920 1080


NO ./path_to_the_north_texture.xpm


SO ./path_to_the_south_texture.xpm


WE ./path_to_the_west_texture.xpm
EA ./path_to_the_east_texture.xpm
S ./path_to_the_sprite_texture.xpm
F 209,0,28
C 0,191,255



         111111111111111111111111111111111111111111111111
        10000000110000000000000000000000000000000000000011
        10110000010100000020000000000000000001111000000001
        100100000000000000000000000000000000001111000000011111111
111111111011000000000N000000000000000000000001111000000000000001
10000000001100001110111111000000000000000000000000000111111111111
11110111111100011000000100000011111000000001111100000000001
11110111101100011101010000000111111100000001000001110000111
110000001101000111000000100000000000100001000000011111111
100020000000000011000000100010000000000000011111111111
1000000000000000000101001000100000000000001111
1100000111010010111110110100011000000000111
11110111 11100101 1011110100011111111111
11111111 11100111 11111111111
111111111111001
111111111111001
111111111111001
           1001
           1001
           1001
           1001
           1111